{
    "어지럽다": 0,
    "나": 1,
    "쉬다": 2,
    "어깨": 3,
    "감사": 4,
    "만나다": 5,
    "잘하다": 6,
    "안녕하세요": 7,
    "무엇": 8,
    "비빔밥": 9,
    "기쁘다": 10,
    "취미": 11,
    "영화": 12,
    "얼굴": 13,
    "보다": 14,
    "이름": 15,
    "같다": 16,
    "죄송": 17,
    "먹다": 18,
    "괜찮다": 19,
    "수고": 20,
    "나이": 21,
    "다시": 22,
    "얼마": 23,
    "날": 24,
    "좋다": 25,
    "날짜": 26,
    "우리": 27,
    "전철": 28,
    "버스": 29,
    "타다": 30,
    "휴대전화": 31,
    "어디": 32,
    "위치": 33,
    "책임": 34,
    "도착": 35,
    "가족": 36,
    "시간": 37,
    "소개": 38,
    "주세요": 39,
    "물음": 40,
    "걷다": 41,
    "자매": 42,
    "공부": 43,
    "사람": 44,
    "지금": 45,
    "어제": 46,
    "겨루다": 47,
    "당신": 48,
    "결혼": 49,
    "노력": 50,
    "아니다": 51,
    "땀": 52,
    "아직": 53,
    "결과": 54,
    "낳다": 55,
    "성공": 56,
    "서울": 57,
    "저녁": 58,
    "고객": 59,
    "바라다": 60
}